wwwwwwwwwwwwwwwwwwwwwww
w..........p..........w
w.....................w
w..wwwww.w.w.w.wwwww..w
w..w...w...w...w...w..w
w..w.b.....w.....b.w..w
w..w...w...w...w...w..w
w..wwwwwwwwwwwwwwwww..w
w.........g.g.........w
wwwwwwwwwwwwwwwwwwwwwww
