wwwwwwwwwwwww
w...........w
w...........w
w...........w
www.wwwww...w
w...b...w...w
w.......w.g.w
w......pw...w
wwwwwwwwwwwww